R   500 500
NO ./textures/1.xpm
SO ./textures/2.xpm
WE ./textures/3.xpm
EA ./textures/4.xpm
S  ./textures/5.xpm
F  1,10,105
C  87,28,81

11111111111111111111111111111
10000000000000000000000000001
10000020202020202020202000001
10000000000000000000000000001
10000000000000000000000000001
10000000000000000000000000001
10000000000000000000000000001
10000000000000N00000000000001
10000000000000000000000000001
10000000000000000000000000001
10000000000000000000000000001
10000000000000000000000000001
10000000000000000000000000001
11111111111111111111111111111
