R 980 640
NO ./textures/colorstone.xpm
SO ./textures/greystone.xpm
WE ./textures/redbrick.xpm
EA ./textures/wood.xpm
S  ./textures/barrel.xpm
F  0,0,150
C  0,150,100

1111111111111111111111
1000000000200000000001
1000000000200000000001
1000000000200000000001
1000202020N02020200001
1000000000200000000001
1000000000200000000001
1000000000200000000001
1111111111111111111111