R 1920 1080
NO ./textures/north.txt
SO ./textures/south.txt
WE ./textures/west.txt
EA ./textures/east.txt
S  ./textures/sprite.txt
F  60,60,60
C  90,90,90

 11111111111111111111111111111111111
 10000000001000000000000100000000001
 10000000001000000000000100000000001
 10000000001000000000000100000000001
 10000000001000000000000100000000001
 11111011111111111N11111111110111111
 10000000001000000000000100000000001
 10000000000000000000000000000000001
 10000000000000000000000000000000001
 10000000001000000000000100000000001
 11111111111111111011111111111111111
 10000000000100000000000100000000001
 10000000000000000000000000000000001
 10000000000100000000000100000000001
 11111111111111111111111111111111111